+----------------------------------------------------------------------+
|  HEADER                                                              |
|  +--------------------------------+    +--------------------------+  |
|  | Каталог сайтов                 |    |      Добавить сайт        |  |
|  +--------------------------------+    +--------------------------+  |
+----------------------------------------------------------------------+
|  BREADCRUMBS                                                        |
|  +----------------------------------------------------------------+  |
|  | Начало > раздел > подраздел                                    |  |
|  +----------------------------------------------------------------+  |
+----------------------------------------------------------------------+
|  MAIN CONTENT (full width)                                          |
|  +----------------------------------------------------------------+  |
|  |                                                                |  |
|  |                                                                |  |
|  |                                                                |  |
|  |                                                                |  |
|  |                                                                |  |
|  |                                                                |  |
|  +----------------------------------------------------------------+  |
+----------------------------------------------------------------------+
|  FOOTER                                                             |
|  +--------------------------------+    +--------------------------+  |
|  | О нас                          |    |        Правила           |  |
|  +--------------------------------+    +--------------------------+  |
+----------------------------------------------------------------------+

